Committer	Name
AA8898	Unknown
Abby Gancz	Abby Gancz
Adrian Forsythe	Adrian Forsythe
Aida Andrades Valtueña	Aida Andrades Valtueña
Alex Huebner	Alex Hübner
Alex Hübner	Alex Hübner
Allaby Lab	Becky Cribdon
Anan Ibrahim	Anan Ibrahim
Anna White	Anna White
ArchaeOphelie	Ophielie Lebrasseur
Aurora Allshouse	Aurora Allshouse
Becky Cribdon	Becky Cribdon
Bjørn Peare Bartholdy	Bjørn Peare Bartholdy
Christina Warinner	Christina Warinner
DianaSpurite	Diana Spurite
Eleanor Green	Eleanor Green
Gunnar Neumann	Gunnar Neumann
I-Ting Huang	I-Ting Huang
Ian Light	Ian Light
Irina Marie Velsko	Irina Velsko
Irina Velsko	Irina Velsko
James A. Fellows Yates	James Fellows Yates
James Fellows Yates	James Fellows Yates
Jasmin F	Jasmin Frangenberg
Javier G. Serrano	Javier G. Serrano
Jesser11	Jessica Hider
Jessica Hider	Jessica Hider
Kadir Toykan Özdoğan	Kadir Toykan Özdoğan
Kelly Blevins	Kelly Blevins
Kevin	Kevin Blevins
MariaThePeople	Maria Lopopolo
Markella Moraitou	Markella Moraitou
Maxime	Maxime Borry
Maxime Borry	Maxime Borry
Maximilian Schumacher	Maximilian Schumacher
Megan Michel	Megan Michel
Meriam van Os	Meriam van Os
Miriam Bravo	Miriam Bravo
Mohamed S. Sarhan	Mohamed S. Sarhan
Nihan D Dagtas	Nihan D Dagtas
Olivia Smith	Olivia Smith
Pete Heintzman	Pete Heintzman
Piotr Rozwalak	Piotr Rozwalak
Raphael Eisenhofer	Raphael Eisenhofer
Sally	Sally Wasef
Shreya Ramachandran	Shreya Ramachandran
Tom Richtermeier	Tom Richtermeier
Valentina Zaro	Valentina Zaro
aidaanva	Aida Andrades Valtueña
alexhbnr	Alex Hübner
anan220606	Anan Ibrahim
arthurKocher	Arthur Kocher
ashildv	Åshild J. Vågene
bbartholdy	Bjørn Peare Bartholdy
darcy220606	Anan Ibrahim
frederik_lutz	Frederik Lutz
genomewalker	Antonio Fernandez Guerra
ilight1542	Ian Light
iseultj	Iseult Jackson
ivelsko	Irina Velsko
jasmezz	Jasmin Frangenberg
jfy133	James Fellows Yates
maxibor	Maxime Borry
mspyrou	Maria Spyrou
pheintzman	Pete Heintzman
theHatIsBack	Unknown
valentinavan	Valentina Vanghi
yaxalponce	Yaxal Ponce
Åshild J. Vågene	Åshild J. Vågene
